8 8
TTTTTTTT
T......T
TLxR*T~T
T..TTT~T
T.+T+~+T
T..TTT~T
T....+.T
TTTTTTTT