16 16
TTTTTTTTTTTTTTTT
T.+.+.*.~~~~~~xT
TTTTTTT~~~~.~R+T
Tx....T.R..R~.~T
T..L..T..TT~~~~T
T..*....+.T.~~~T
T.TTT.TTTTTR~~~T
T.T+T.T..+.R~~+T
T.TxT.TTT...~~~T
T.TRT...T+..~~~T
T+T.TTT~T.+TTT~T
T.T...T~TTTT...T
T+T.~.T~T.+.+..T
T.T~+~~~~~~~~~.T
T~~~......+~~~+T
TTTTTTTTTTTTTTTT